1111111111111111111111111111111
1000000000000000000000000000001
100000000000000P000000002000001
1000000020000000000000000000001
1000000000000000000000000C00001
1000000000E00000000200000000001
1000000000000000000000000000001
1000000000000000C00000000000001
1111111111111111111111111111111