11111111111111111111
11111111111111111111
11111111111111111111
11100C00000000000111
11101111100111110111
11101111120111110111
11101111100111110111
11101111100111110111
11101111100111110111
11101111100111110111
11101111100111110111
111011111P0111110111
11101111100111110111
11101111100111110111
11101111100111110111
11101111100111110111
11101111100111110111
11101111100111110111
111011111E0111110111
11111111111111111111